                                        
                         X              
                                        
                               _________
                    #         |         
                    #         |         
                    #         |         
                    #         |    X    
